 W  W  W  W  W  W  W  W  W  W  W  W  W  W  W  W  W  W  W  W 
 [  #  #  #  5  #  #  #  #  #  #  #  #  1  7  #  4  7  #  ] 
 [  3  5  #  1  4  #  6  6  2  #  2  #  1  1  1  #  4  5  ] 
 [  #  #  6  6  2  2  1  5  #  2  2  #  #  1  #  3  #  3  ] 
 [  #  #  #  #  #  #  3  #  #  7  #  #  2  3  #  #  2  #  ] 
 [  #  7  #  #  #  #  1  #  7  5  6  2  4  3  7  #  #  3  ] 
 [  7  #  2  #  #  #  #  5  #  #  #  2  #  7  1  #  #  #  ] 
 [  #  #  #  #  #  #  2  2  #  #  #  #  #  #  #  #  #  #  ] 
 [  #  6  2  ]  W  W  W  [  5  3  #  1  #  3  #  #  7  1  ] 
 #  2  #  #  ]  W  W  W  [  #  #  #  ]  W  W  W  [  #  #  ] 
 7  #  #  #  ]  W  W  W  [  5  #  #  ]  W  W  W  [  #  4  ] 
 [  #  5  7  ]  W  W  W  [  #  1  2  ]  W  W  W  [  5  2  ] 
 [  #  #  4  ]  W  W  W  [  #  #  #  1  #  #  #  #  5  3  ] 
 #  3  #  #  5  #  4  #  4  #  #  2  1  3  6  7  #  #  3  ] 
 #  #  #  6  #  5  #  #  2  #  4  #  #  #  #  #  #  #  1  ] 
 [  4  #  2  2  3  7  6  #  4  5  5  1  1  #  #  7  1  #  ] 
 [  #  #  #  #  #  #  #  #  #  5  3  #  1  7  #  7  #  6  ] 
 [  7  3  6  #  6  4  #  5  #  #  4  #  #  #  #  #  #  6  ] 
 [  #  #  #  5  #  #  #  6  4  #  #  2  #  #  1  1  5  5  ] 
 W  W  W  W  W  W  W  W  W  W  W  W  W  W  W  W  W  W  W  W 
