 W  W  W  W  [  #  #  ]  W  W  W  W 
 [  5  #  2  4  3  6  #  #  7  #  ] 
 [  #  #  #  #  4  #  #  #  #  5  ] 
 [  6  4  #  2  #  7  1  #  #  1  ] 
 [  #  #  3  7  ]  W  W  [  7  1  ] 
 [  #  #  #  5  ]  W  W  [  4  #  # 
 [  #  4  #  #  ]  W  W  [  7  #  2 
 [  #  1  #  #  ]  W  W  [  7  #  ] 
 [  #  5  1  1  ]  W  W  [  #  #  ] 
 [  3  3  6  4  #  6  6  #  #  #  ] 
 [  4  #  #  4  5  #  #  7  4  5  ] 
 W  W  W  W  W  W  W  W  W  W  W  W 
