 W  W  W  W  W  W  W  W  W  W  W  W  W  W  W  W  W  W  W  W  W  W  W  W 
 [  2  1  #  4  #  #  6  4  #  #  #  #  2  #  #  #  #  #  2  4  5  4  ] 
 [  #  4  3  3  #  #  6  #  #  #  4  #  #  #  2  #  #  3  #  1  #  #  ] 
 [  #  4  7  4  #  5  3  2  #  4  #  #  #  1  #  #  4  #  #  5  5  6  ] 
 [  #  7  #  4  #  #  4  4  6  7  7  #  2  #  5  #  #  3  7  7  #  #  ] 
 [  4  #  5  1  #  1  4  #  #  4  #  #  #  2  #  #  5  #  #  7  #  #  # 
 [  #  #  #  2  5  #  #  #  #  #  2  #  5  2  4  #  #  #  3  4  #  3  1 
 [  #  #  #  1  #  2  #  3  #  #  #  3  #  #  #  #  4  #  6  3  #  #  ] 
 [  #  2  5  #  #  #  #  1  #  #  #  #  #  3  #  3  #  #  #  #  4  #  ] 
 [  4  #  #  #  7  #  7  #  #  5  #  #  6  2  #  2  7  #  2  3  #  4  ] 
 [  #  4  4  6  #  #  4  #  #  #  #  #  #  1  #  4  6  3  4  #  #  2  ] 
 [  #  6  6  #  #  2  2  2  7  #  6  #  #  3  #  5  #  #  #  #  #  #  ] 
 [  #  7  #  6  #  2  4  #  6  #  4  #  #  #  #  #  #  #  6  6  6  #  ] 
 [  #  #  #  #  4  1  3  #  #  #  #  #  #  #  #  3  #  6  1  3  4  #  ] 
 [  #  #  #  7  4  #  2  #  #  #  6  #  #  #  6  #  4  5  2  #  #  1  ] 
 W  W  W  W  W  W  W  W  W  W  W  W  W  W  W  W  W  W  W  W  W  W  W  W 
